111111111111111111
1P00E00C0001001001
10C000000001111001
111C010000C0000C01
101111000000101111
100C0000000010C001
111111111111111111
