1111111
1P000E1
1000C01
1111111
